WWWWWWWW
WWDDDWWW
WDDDDDDW
WDDDDDDW
WDDWWDDW
WDWWDDDW
WWWWWWDW
WWWWWWWW
